00=groundGrass0
01=decoTreePine
02=groundGrass1
03=decoLogL
04=decoLogR
05=decoCampfire
00;01;01;01;01;01;01;01;01;01;01;01;01;01;01;01;01;01;01;01;01;01;01;01;01;01;01;01;01;01;01;01;00;00;00;00;00;00;00;00;00;00;00;00;00;00;00;00;00;00;00;00;00;00;00;00;00;00;00;00;00;00;00;00
01;01;01;01;01;01;01;01;01;01;01;01;01;01;01;01;01;01;01;01;01;01;01;01;01;01;01;01;01;01;01;01;00;00;00;00;00;00;00;00;00;00;00;00;00;00;00;00;00;00;00;00;00;00;00;00;00;00;00;00;00;00;00;00
01;01;01;01;01;01;01;01;01;01;01;01;01;01;01;01;01;01;01;01;01;01;01;01;01;01;01;01;01;01;01;01;00;01;01;01;01;00;00;00;00;01;01;00;00;00;00;00;01;00;00;00;00;00;01;00;00;00;01;01;01;00;01;01
01;01;01;01;01;01;01;01;01;01;01;01;01;01;01;01;01;01;01;01;01;01;01;01;01;01;01;01;01;01;01;01;01;01;01;01;01;01;01;01;01;01;01;01;01;01;01;01;01;01;01;01;01;01;01;01;01;01;01;01;01;01;01;00
01;01;01;01;01;01;01;01;01;01;01;00;01;01;01;01;01;01;01;01;01;00;01;00;00;00;01;00;01;01;01;01;01;01;01;01;01;01;01;01;01;01;01;01;01;01;01;01;01;01;01;01;01;01;01;01;01;01;01;01;01;01;01;01
01;01;01;01;01;01;01;00;00;01;00;00;00;00;00;00;00;00;00;00;00;00;00;00;00;00;00;00;00;00;00;00;00;00;00;01;00;00;00;00;00;01;00;00;00;00;00;00;00;00;00;00;00;00;00;00;00;00;01;01;00;00;00;00
01;01;00;00;02;00;00;00;00;00;00;00;00;00;00;00;00;00;00;00;00;00;00;00;00;00;00;00;00;00;00;00;00;00;00;00;00;00;00;00;00;00;00;00;00;00;00;00;00;00;00;00;00;00;00;00;00;00;00;00;00;00;01;01
01;00;00;00;00;00;00;00;00;00;00;00;00;00;00;00;00;00;00;00;00;00;00;00;00;00;00;00;00;00;00;00;00;00;00;00;00;00;00;00;00;00;00;00;00;00;00;00;00;00;00;00;00;00;00;00;00;00;00;00;00;00;01;00
01;01;00;00;00;00;00;00;00;00;00;00;00;00;00;00;00;00;00;00;00;00;00;00;00;00;00;00;00;00;00;00;00;00;00;00;00;00;00;00;00;00;00;00;00;00;00;00;00;00;00;00;00;00;00;00;00;00;00;00;00;00;01;01
01;00;02;00;00;00;00;00;00;00;00;00;00;00;00;00;00;00;00;00;00;00;00;00;00;00;00;00;00;00;00;00;00;00;00;00;00;00;00;00;00;00;00;00;00;00;00;00;00;00;00;00;00;00;00;00;00;00;00;00;00;00;01;00
01;01;00;03;00;04;00;00;00;00;00;00;00;00;00;00;00;00;00;00;00;00;00;00;00;00;00;00;00;00;00;00;00;00;00;00;00;00;00;00;00;00;00;00;00;00;00;00;00;00;00;00;00;00;00;00;00;00;00;00;00;00;01;01
01;00;00;00;00;00;00;00;00;00;00;00;00;00;00;00;00;00;00;00;00;00;00;00;00;00;00;00;00;00;00;00;00;00;00;00;00;00;00;00;00;00;00;00;00;00;00;00;00;00;00;00;00;00;00;00;00;00;00;00;00;00;00;00
01;01;00;00;05;00;00;00;00;00;00;00;00;00;00;00;00;00;00;00;00;00;00;00;00;00;00;00;00;00;00;00;00;00;00;00;00;00;00;00;00;00;00;00;00;00;00;00;00;00;00;00;00;00;00;00;00;00;00;00;00;00;01;01
01;00;00;00;00;00;00;00;00;00;00;00;00;00;00;00;00;00;00;00;00;00;00;00;00;00;00;00;00;00;00;00;00;00;00;00;00;00;00;00;00;00;00;00;00;00;00;00;00;00;00;00;00;00;00;00;00;00;00;00;00;00;01;00
01;01;00;00;00;00;00;00;00;00;00;00;00;00;00;00;00;00;00;00;00;00;00;00;00;00;00;00;00;00;00;00;00;00;00;00;00;00;00;00;00;00;00;00;00;00;00;00;00;00;00;00;00;00;00;00;00;00;00;00;00;00;01;01
01;00;00;00;00;00;00;00;00;00;00;00;00;00;00;00;00;00;00;00;00;00;00;00;00;00;00;00;00;00;00;00;00;00;00;00;00;00;00;00;00;00;00;00;00;00;00;00;00;00;00;00;00;00;00;00;00;00;00;00;00;00;01;00
01;01;00;00;00;00;00;00;00;00;00;00;00;00;00;00;00;00;00;00;00;00;00;00;00;00;00;00;00;00;00;00;00;00;00;00;00;00;00;00;00;00;00;00;00;00;00;00;00;00;00;00;00;00;00;00;00;00;00;00;00;00;01;00
01;00;00;00;00;00;00;00;00;00;00;00;00;00;00;00;00;00;00;00;00;00;00;00;00;00;00;00;00;00;00;00;00;00;00;00;00;00;00;00;00;00;00;00;00;00;00;00;00;00;00;00;00;00;00;00;00;00;00;00;00;01;01;00
01;01;00;00;00;00;00;00;00;00;00;00;00;00;00;00;00;00;00;00;00;00;00;00;00;00;00;00;00;00;00;00;00;00;00;00;00;00;00;00;00;00;00;00;00;00;00;00;00;00;00;00;00;00;00;00;00;00;00;00;00;00;01;00
00;00;00;00;00;00;00;00;00;00;00;00;00;00;00;00;00;00;00;00;00;00;00;00;00;00;00;00;00;00;00;00;00;00;00;00;00;00;00;00;00;00;00;00;00;00;00;00;00;00;00;00;00;00;00;00;00;00;00;00;00;00;01;00
00;01;00;00;00;00;00;00;00;00;00;00;00;00;00;00;00;00;00;00;00;00;00;00;00;00;00;00;00;00;00;00;00;00;00;00;00;00;00;00;00;00;00;00;00;00;00;00;00;00;00;00;00;00;00;00;00;00;00;00;00;00;01;00
00;00;00;00;00;00;00;00;00;00;00;00;00;00;00;00;00;00;00;00;00;00;00;00;00;00;00;00;00;00;00;00;00;00;00;00;00;00;00;00;00;00;00;00;00;00;00;00;00;00;00;00;00;00;00;00;00;00;00;00;00;00;01;00
00;01;00;00;00;00;00;00;00;00;00;00;00;00;00;00;00;00;00;00;00;00;00;00;00;00;00;00;00;00;00;00;00;00;00;00;00;00;00;00;00;00;00;00;00;00;00;00;00;00;00;00;00;00;00;00;00;00;00;00;00;00;01;00
01;01;00;00;00;00;00;00;00;00;00;00;00;00;00;00;00;00;00;00;00;00;00;00;00;00;00;00;00;00;00;00;00;00;00;00;00;00;00;00;00;00;00;00;00;00;00;00;00;00;00;00;00;00;00;00;00;00;00;00;00;00;01;00
00;01;00;00;00;00;00;00;00;00;00;00;00;00;00;00;00;00;00;00;00;00;00;00;00;00;00;00;00;00;00;00;00;00;00;00;00;00;00;00;00;00;00;00;00;00;00;00;00;00;00;00;00;00;00;00;00;00;00;00;00;00;01;00
01;01;00;00;00;00;00;00;00;00;00;00;00;00;00;00;00;00;00;00;00;00;00;00;00;00;00;00;00;00;00;00;00;00;00;00;00;00;00;00;00;00;00;00;00;00;00;00;00;00;00;00;00;01;00;00;00;00;00;00;00;00;01;00
01;01;00;00;00;00;01;01;00;00;00;00;00;00;01;01;00;00;00;00;00;01;00;00;01;00;01;00;00;01;00;00;00;00;00;00;00;01;00;00;00;00;00;00;00;00;00;00;00;00;01;01;01;01;01;01;00;00;00;00;00;00;01;00
00;01;01;01;01;01;01;01;01;01;01;01;01;01;01;01;01;01;01;01;01;01;01;01;01;01;01;01;01;01;00;01;01;01;01;01;01;01;01;00;01;01;01;00;01;01;00;01;01;01;01;01;01;00;01;01;01;00;00;00;00;01;01;00
01;01;01;01;01;01;01;01;01;01;01;01;01;01;01;01;01;01;01;01;01;01;01;01;01;01;01;01;01;01;01;01;01;01;01;01;01;00;01;01;01;01;01;01;01;01;01;01;01;01;01;01;00;01;01;01;01;01;01;01;01;01;01;00
01;01;01;01;01;01;01;01;01;01;01;01;01;01;01;01;01;01;00;01;01;01;01;01;01;01;01;01;01;01;01;01;01;01;01;01;01;01;01;01;01;01;01;01;01;01;01;00;00;01;01;01;01;01;01;01;01;01;01;01;01;01;01;00
01;01;01;01;01;01;01;00;00;00;00;00;00;00;00;00;00;00;00;00;00;00;00;00;00;00;01;01;01;01;01;01;01;01;01;01;01;01;01;01;01;01;01;01;01;01;01;01;01;00;01;01;00;00;01;01;01;01;01;00;00;01;01;01
01;01;01;01;01;01;00;00;00;00;00;00;00;00;00;00;00;00;00;00;00;00;00;00;00;00;01;01;01;01;01;00;00;00;01;00;00;00;01;01;00;00;01;01;01;01;01;01;01;01;00;00;00;00;01;00;01;01;01;01;01;01;01;00